5,4,4,4,1,4,4,4,2,4,4,4,4,4,4,2,3,4,1,1,
5,5,4,4,4,4,4,4,4,4,4,4,4,4,4,2,3,4,1,1,
4,5,4,4,4,4,3,4,4,5,5,5,5,4,4,2,3,4,5,1,
4,5,5,5,4,4,4,4,4,5,4,1,5,4,4,2,3,4,1,1,
4,4,4,5,5,5,5,5,5,5,4,4,5,4,4,2,3,4,1,1,
4,4,4,4,4,4,2,4,4,4,4,4,5,4,4,2,3,4,1,1,
4,1,4,4,4,4,4,4,4,3,4,4,5,4,4,2,3,4,1,1,
4,4,4,4,4,4,4,4,4,4,4,2,5,4,4,2,3,4,1,1,
4,4,2,4,4,4,1,2,4,4,4,4,5,4,5,2,3,4,1,1,
3,4,4,4,4,4,4,4,4,4,4,1,5,5,5,2,3,4,1,1,
